111111
101111
100111
111011
111101
111111