11111
10001
11101
11101
11101
  101
  111