11111
10001
11101
111001
111111