1111111111111111111111111111111
1010000010000010100000101010101
1010111011101110111110101010101
1000001000100000000010001010101
1111101110101010101011101010101
1010100010101010101000001010001
1010111010101011111011111010111
1000001010001000001010000000001
1111101111111011111010111111101
1000000010000000001010100010101
1110111110111111111110101110111
1000100000001010001010100000101
1010101111101010101010101111101
1010101000001000101000001000101
1011111111101110101110111011101
1000000010101000101000100010101
1111101010101011101011101110101
1010101000001010101000001010001
1010111111101010111111101010111
1000001000000010101000001010101
1011111010111010101110111010101
1010000010100010000010101010101
1010111011101111101010101010101
1000100010000000001000000000001
1111111111111111111111111111111
